F 100,100,114
C 135,197,114

EA ./images/4.xpm
NO ./images/2.xpm
SO ./images/3.xpm
WE ./images/1.xpm

1111111111
1000000111
1111101111
111110111111111111111111111111111111111111
110000000100000110000000000000000000000001
11100000010000011000000000000000001001000111111111111111111111111111111                     
1111110100000001100000000000000000110000000000000000000000010000001
1000000000000001100000000001111110101111111111111111111110000111101
1111110000000001100000010000000000100001100000100000000000000000001
1001001010011111111100000000100001011000001111111111111111111111111
100000000001       100000000000100000000001
1000001010111111111100000000000010110000111
1111110000000001100000000000000100100000001
100011100000E000000000111111100000100000001      
10000000000000011000000001  100000000000001
1000000000000001100000000111100000100000001
1000000000000001100000000000000000100100001
1000000000000001100000000000000000100000001
1000000000000001100000000000000000100000001
1111111111111111111111111111111111111111111