WE ./maps/new.cub
EA ./maps/test.cub

F  240,        240,      240

C     50        ,50      ,50

SO                    ./maps/test.cub
NO  ./maps/test.cub

1111111
1000001
1011101
1010101
1012101
1000001
1000001
100N001
1111111
