WE ./maps/new.cub
EA ./maps/test.cub

F  240,        240,      240

C     50        ,50      ,50

SO                    ./maps/test.cub
NO  ./maps/test.cub

11111111111
10000000001
10011210001
10111001101111111
10100001000000001
10121111000000001
10000000000000001
10000000000001111
100N0000000001
11111111111111
