WE ./maps/new.cub
EA ./maps/test.cub

F  240,        240,      240

C     120        ,120      ,120

SO                    ./maps/test.cub
NO  ./maps/test.cub

  111111111111111111111111
1111000000000000000000W111
  101100000111111111110111
  10010001011        101
  1011000001111111 11101111
  1000000000000011110101111
  1000000010000000000101001
  1101000111011111110000111
  11000001 101 111111000111
  1111111111111111111111111
  11 11 111
        111111
