WE ./maps/new.cub
EA ./maps/test.cub

F  240,        240,      240

C     50        ,50      ,50

SO                    ./maps/test.cub
NO  ./maps/test.cub

  111111111111111111111111
11100000000000000000000111
  101100000111111111110111
  10001000101        101
  1001000001111111 11101111
  10000000000000111100W1111
  1001000000000000000001001
  1001000000000000000001001
  1001000000000000000001001
  1001000000000000000001001
  1001000000000000000001001
  1100100111011111110000011
  11000001 101 111111000111
  1111111111111111111111111
  11 11 111
        111111
