SO images/5.xpm
WE images/5.xpm
NO images/5.xpm
EA images/5.xpm

F 220,100,0
C 225,30,0

FOR THIS MAP TO WORK PROPERLY, REMOVE THE SHADER (draw.c line: 27+28)

11111111111111111111111111111111111111111
1E002010201020201020202010202020201010201
11121212121211121211121112111211121211121
10201020101010121000100000101010200020201
12121112111112101111111212121112111111111
10101010100000200010200010100010100010001
10111011111111111012111110121111111210101
10101010001000001010000010000010100000101
10101010101112111011101011111110111111101
10002010101000201000001010100010001000001
10101010111111121110111110101111101011101
10101020000010000010002000000010002000101
11101010111110111010101011101110111111111
10101010200000100000101000102000102000001
10101110111010111010101111111110101111101
10001000001010001010101000000010000010101
10111011101112121011111211101112111210121
10100010201010101020001000100010001010101
10111212101211101111101011121111101012101
10100010101000101000100000100010101010001
12111010101110121110121011111110111011101
10101010102000101000201000100010201010101
10101110101111111110101111121110101010101
10201000100010000000100010000012101010101
12121211121212121111111110111112111212111
10101010001010102000000020100200100010201
10101011111011111111111110101111111111101
10101000101020001020001000101020001020001
11101110101111111010111110101010111011111
10201000200010002010100010000010100020001
10111111111011101010101111111112111111101
10100020001020001010200010200010201010201
11101010111110111011111010111111101010101
10001010100000100000001010100000100010101
10101110101011101111121110101110111010111
10101000101010000010202010001000000010001
10101011101010111011111111111010111010101
10101020001010101000202000001010201000101
10101111111010101011101111101011101111121
10102000100010201010002000101010202000101
11111111111111111111111111111111111111111
