        111111 1111111 11111111
        100001 1001101 1000000111
        1011011101110111000100111
        1001000000000000000000001
111111111011000001110000000000001
100000000011000001110111111111111
11110111111111011100000010001
11110111111111011101010010001
11000000110101011100000010001
10001000000000001100000010001
10000000000000001101010010001
11000001110101011111011110N0111
11110111111101011101111010001
 1111111111111111111111111111