  11111111111111111111111111
11110000000000000000000111
  101100000111111111111111
  10010001011
  1011000001111111 11111111
  1000000000000011110101111 1
  1000000010000000000101001
  1102000111011111110000111
  11000001 101 1111110N0111
  1111111111111111111111111
  11 11 111
        111111